1111111111111
1C010000C00C1
10010C0000001
1000C11111001
1P0C11E00C001
1111111111111
