11111111111111
1C0100M00C00C1
10010C000000M1
1000C111000001
1P0C11E000C001
11111111111111
