111111111111111111111111111
11000000000C0000010000000C1
1001000CC001000M000C0C00001
1C0011101111110111111000C01
1M0010111C00001000010C00001
10101000C001100C010M10C0001
1P001MEM000010M10000C000001
111111111111111111111111111
